[
  "############################################################",
  "#~~~~~...........................~~~~.................~~~~~#",
  "#~~~~~...........................~~~~.................~~~~~#",
  "#.....AAAA............................................~~~~~#",
  "#.....AAAA.......DDD....................BBBBB..............#",
  "#.....AA.........DDD...DDDDDD...........BBBBB..............#",
  "#.....AAa........DdD...DDdDDD............BbB........DDD....#",
  "#.......ggg...............................g.........dDD....#",
  "#.........ggggggggggggggggggggggggggggggggggggggggg.DDD....#",
  "#.........~~~.g.g...g.......g.......g.~~..........g~~~~~~~.#",
  "#.............S.g...g~~~~~~~g~~~~~~~gg~~ggggggggg.g~~~~~~~.#",
  "#.........~~ggggg...g~~~~~~~g.......g.............g~~~~~~~.#",
  "#.............g.....ggggggggggggggggggggggg.......g~~~~~~~.#",
  "#.............g~~...g~~~~~~~g.....g.g.............g~~~~~~~.#",
  "#.............g~~.g.g~~~~~~~g.....g.g.........ggggg~~~~~~~.#",
  "#...DD........g...g..~~~~~~~g..DDDD.g..........DDDDDD......#",
  "#...dD.....~ggggggggggggggggg..DDDD.g..........DDdDDD......#",
  "#..........~..g...g.....g......DdDD.g......................#",
  "#.....~~~~~~..g...g.....g.........ggg......................#",
  "#.................g.....g.DDDD....g........................#",
  "#.................g.....g.DDDd....g........................#",
  "#.................g.....g.DDDD....g........................#",
  "#.............ggggDDDDD.ggggggg...g........................#",
  "#.................DDDDD.......g...ggggg~gggggg.............#",
  "#.......DDDggggg...DdDg.......g~~~~~~~~~.....g......DD.....#",
  "#.......D~D.g.........g.......g~~~~~~~~~.....g......dD.....#",
  "#.......g~D.g.........g.......g.......DDDDD..g.............#",
  "#.......D~D.g.........g.......g.......D~~~D~~~.............#",
  "#.......DDD.g.........gggggg..g........D~D...gXXX..........#",
  "#.......g...g.................g..............gXXX..........#",
  "#....DDDg...g.................ggggggggggggggggxXX..........#",
  "#....D~Dg...g..............................g.gXXXgggg......#",
  "#....D.Dgggggggg...............DDDDDD......g..XXX...g......#",
  "#~~~~.......DDD................D~~~~D......g........g..~~~~#",
  "#~~~~.......DDD.........~~~~...............ggggggg~gggggggG#",
  "#~~~~.~~~~..DDD.........~~~~..............~~~~....~~~~~~~~~#",
  "#~~~~.~~~~..DDD.........~~~~..............~~~~~~~~~~~~~~~~~#",
  "#~~~~.~~~~..DdD.........~~~~..............~~~~....~~~~~~~~~#",
  "#~~~~.~~~~................................~~~~....~~~~~~~~~#",
  "############################################################"
]
